A A A A A A A A A A A A A A A A A A A A A A A A A A A A A A A A A A A A A A A A A A A A A A A A A A A A A A A A A A A A
A A A A A A A A A A A A A A A A A A A A A A A A A A A A A A A A A A A A A A A A A A A A A A A A A A A A A A A A A A A A
A A A A A A A A A A A A A A A A A A A A A A A A A A A A A A A A A A A A A A A A A A A A A A A A A A A A A A A A A A A A
A A A A A A A A A A A A A A A A A A A A A A A A A A A A A A A A A A A A A A A A A A A A A A A A A A A A A A A A A A A A
A A A A A A A A A A A A A A A A A A A A A A A A A A A A A A A A A A A A A A A A A A A A A A A A A A A A A A A A A A A A
A A A A A A A A A A A A A A A A A A A A A A A A A A A A A A A A A A A A A A A A A Q A A A A A A A A A A A A A A A A A A
A A A A A A A A A A A A A A A A A A A A A A A A A A A A A A A A A A A A A A A A A A A A A A A A A A A A A A A A A A A A
A A A A A A A A A A A A A A A A A A A A A A A A A A A A A A A A A A A A A A A A A A A A A A A A A A A A A A A A A A A A
A A A A A A A A A A A A A A A A A A A A A A A A A A A A A A A A A A A A A A A A A A A A A A A A A A A A A A A A A A A A
A A A A A A A A A A A A A A A A A A A A A A A A A A A A A A A A A A A A A A A A A A A A A A A A A A A A A A A A A A A A
A A A A A A A A A A A A A A A A A A A A A A A A A A A A A A A A A A A A A A A A A A A A A A A A A A A A A A A A A A A A
A A A A A A A A A A A A A A A A A A A A A A A A A A A A A A A A A A A A A A A A A A A A A A A A A A A A A A A A A A A A
A A A A A Q A A A A A A A A A A A A A A A Q A A A A A A A A A A A A A A A A A A A A A A A A A A A A A A A A A A A A A A
A A A A A A A A A A A A A A A A A A A A A A A A A A A A A A A A A A A A A A A A A A A A A A A A A A A A A A A A A A A A
A A A A A A A A A A A A A A A A A A A A A A A A A A A A A A A A A A A A A A A A A A A A A A A A A A A A A A A A A E E E
A A A A A A A A A A A A A A A A A A A A A A A A A A A A Q A A A A A A A A A A A A A A A A A A A A A A A A A E E E E E E
A A A A A A A A A A A A A A A A A A A A A A A A A A A Q A Q A A A A A A A A A A A A A A A A A A A A A A E E E E E E E E
A A A A A A A A A A A A A A A A A A A A A A A A A A A A Q A A A A A A A A A A A A A A A A A A A A A E E E E E E E E E E
A A A A A A A A A A A A A A A A A A A A A A A A A A A A A A A A A A A A A A A A A A A A A A A A E E E E E E E E E E E S
A A A A A A A A A A A A A A A A A A A A A A A A A A A A A A A A A A A A A A A A A A A A A A A E E E E E E E E E S S S S
A A A A A A A A A A A A A A A A A A A A A A A A A A A A A A A A A A A A A A A A A A A A A E E E E E E E E E S S S S S S
A A A A A A A A A A A A Q A A A A A A A A A A A A A A A A A A A A A A A A A A A A A A E E E E E E E E E S S S S S S S S
A A A A A A A A A A A A A A A A A A A A A A A A A A A A A A A A A A A A A A A A A A E E E E E E E E S S S S S S S S S S
A A A A A A A A A A A A A A A A A A A A A A A A A A A A A A A A A A A A A A A A E E E E E E E E S S S S S S S S S S S S
A A A A A A A A A A A A A A A A A A A A A A A A A A A A A A A A A A A A A A A E E E E E E E S S S S S S S S S S S S S S
A A A A A A A A A A A A A A A A A A A A A A A A A A A A A A A A A A A A A A E E E E E E E S S S S S S S S S S S S S S S
A A A A A A A A A A A A A A A A A A A A A A A A A A A A A A A A A A A A A E E E E E E E S S S S S S S S S S S S S S S S
A A A A A A A A A A A A A A A A A A A A A A A A A A A A A A A A A A A E E E E E E E S S S S S S S S S S S S S S S S S S
A A A A A A A A A A A A A A A A A A A A A A A A A A A A A A A A A A E E E E E E E S S S S S S S S S S S S S S S S S S S
A A A A A A A A A A A A A A A A A A A A A A A A A A A A A A A A A E E E E E E E S S S S S S S S S S S S S S S S S S S S
A A A A A A A A A A A A A A A A A A A A A A A A A A A A A A A A E E E E E E E S S S S S S S S S S S S S S S S S S S S S
A A A A A A A A A A A A A A A A A A A A A A A A A A A A A A A E E E E E E E S S S S S S S S S S S S S S S S S S S S S S
A A A A A A A A A A A A A A A A A A A A A A A A A A A A A A E E E E E E E S S S S S S S S S S S S S S S S S S S S S S S
A A A A A A A A A A A A A A A A A A A A A A A A A A A A A A E E E E E E E S S S S S S S S S S S S S S S S S S S S S S S
A A A A A A A A A A A A A A A A A A A A A A A A A A A A A E E E E E E E S S S S S S E E E E S S S S S S S S S S S S S S
A A A A A A A A A A A A A A A A A A A A A A A A A A A A E E E E E E E S S S S S S E E E E E S S S S S S S S S S S S S S
A A A A A A A A Q A A A A A A A A A A A A A A A A A A E E E E E E E E S S S S S E E E E E E S S S S S S S S S S S S S S
A A A A A A A Q A Q A A A A A A A A A A A A A A A A E E E E E E E E S S S S S E E E E E E E S S S S S S S S S S S S S S
A A A A A A A A Q A A A A A A A A A A A A A A A A A E E E E E E E S S S S S E E E E E E E E S S S S S S S S S S S S 2 1
A A A A A A A A A A A A A A A A A A A A A A A A A E E E E E E E E S S S S S E E E E E E E S S S S S S S S S S S S 1 1 3
A A A A A A A A A A A A A A A A A A A A A A A A A E E E E E E E S S S S S E E E E E E E E S S S S S S S S S S S 2 1 3 Q
A A A A A A A A A A A A A A A A A A A A A A A A E E E E E E E E S S S S S E E E E E E E S S S S S S S S S S S 1 1 Q 3 3
A A A A A A A A A A A A A A A A A A A A A A A E E E E E E E E E S S S S S E E E E E S S S S S S S S S S S S 1 2 Q 3 3 3
A A A A A A A A A A A A A A A A A A A A A A A E E E E E E E E S S S S S S S E S E S S S S S S S S S S S S 1 2 Q 3 3 Q Q
A A A A A A A A A A A A A A A A A A A A A A E E E E E E E E E S S S S S S S S S S S S S S S S S S S 2 2 1 1 2 3 2 Q Q Q
A A A A A A A A A A A A A A A A A A A A A A E E E E E E E E S S S E S S S S S S S S S S S 3 2 1 1 1 2 2 2 2 1 2 3 3 Q Q
A A A A A A A A A A A A A A A A A A A A A E E E E E E E E E S S E E S S S S S S S 3 2 2 1 1 2 2 2 2 2 2 2 1 3 3 3 2 3 Q
A A A A A A A A A A A A A A A A A A A A A E E E E E E E E E S E E E S S S S 3 2 1 1 1 2 2 2 2 2 2 2 3 3 1 2 Q Q 3 3 2 3
A A A A A A A A A A A A A A Q A A A A A E E E E E E E E E S E E E E S S 2 1 1 1 2 2 2 2 2 2 2 3 3 3 Q 2 1 Q Q Q Q Q 3 2
A A A A A A A A A A A A A A A A A A A A E E E E E E E E E E E E E E S 1 1 2 2 2 2 2 2 3 3 3 3 3 3 3 2 1 3 3 Q Q Q Q Q 3
A A A A A A A A A A A A A A A A A A A A E E E E E E E E E E E E E S S 1 2 2 1 2 3 3 3 3 3 3 3 3 2 2 2 1 2 1 1 Q Q Q Q Q
A A A A A A A A A A A A A A A A A A A E E E E E E E E E E E E E E S S 1 3 1 2 2 3 3 3 3 3 2 2 2 2 1 1 1 3 Q 2 1 3 Q Q Q
A A A A A A A A A A A A A A A A A A A E E E E E E E E E E E E E E S S 1 3 2 1 2 2 3 2 2 2 2 2 2 1 2 1 3 Q Q Q 2 1 3 Q Q
A A A A A A A A A A A A A A A A A A A E E E E E E E E E E E E E E S S 1 2 3 2 1 2 2 2 2 2 2 2 1 2 Q 2 Q Q Q Q Q 2 1 3 Q
A A A A A A A A A A A A A A A A A A E E E E E E E E E E E E E E S S S 1 1 2 3 1 1 2 3 3 3 3 1 2 Q 1 2 Q Q Q Q Q Q 2 1 3
A A A A Q A A A A A A A A A A A A A E E E E E E E E E E E E E E S S S 1 1 1 2 3 2 1 3 3 2 2 2 3 3 1 3 Q Q Q Q Q Q Q 2 1
A A A Q A Q A A A A A A A A A A A A E E E E E E E E E E E E E E S S S 2 1 2 1 1 2 2 1 2 3 2 2 3 1 1 Q Q Q Q Q Q Q Q Q 2
A A A A Q A A A A A A A A A A A A E E E E E E E E E E E E E E S S S S 2 1 2 2 1 1 2 2 1 2 2 3 Q 1 1 Q Q Q Q Q 3 2 2 3 2
A A A A A A A A A A A A A A A A A E E E E E E E E E E E E E E S S S S 2 1 2 1 2 2 1 2 2 2 1 3 Q 2 1 Q Q Q Q 1 1 1 1 1 1
A A A A A A A A A A A A A A A A A E E E E E E E E E E E E E S S S S S 2 1 2 1 1 2 1 1 2 1 1 3 Q 3 1 2 Q Q 2 1 1 1 1 1 1
A A A A A A A A A A A A A A A A A E E E E E E E E E E E E S S S S S S 2 1 2 2 1 1 1 2 2 2 1 3 Q 3 2 1 3 Q 1 1 1 1 1 1 1
A A A A A A A A A A A A A A A A A E E E E E E E E E E E E S S S S S S 3 1 1 1 1 2 3 3 3 2 1 3 Q 3 3 1 1 1 1 1 1 1 1 1 1
A A A A A A A A A A A A A A A A E E E E E E E E E E E E S S S S S S S 2 1 1 2 3 3 3 2 2 2 1 3 Q Q 3 3 1 1 1 1 1 1 1 1 1
A A A A A A A A A A A A A A A A E E E E E E E E E E E E S S S S S S 2 1 2 3 3 3 2 2 2 2 1 1 3 Q Q 3 3 2 1 1 1 1 1 1 1 1
A A A A A A A A A A A A A A A A E E E E E E E E E E E E S S S S S 2 1 2 2 2 3 3 3 3 3 2 2 1 3 Q Q 3 2 2 1 1 1 1 1 1 1 1
A A A A A A A A A A A A A A A A E E E E E E E E E E E E S S S S 3 1 3 2 2 2 1 2 3 3 3 2 2 1 3 Q Q Q 2 3 1 2 2 1 1 1 1 1
A A A A A A A A A A A A A A A A E E E E E E E E E E E E E S S S 2 1 3 2 3 3 2 2 2 3 3 2 2 1 2 3 Q Q 2 3 1 3 2 1 1 1 1 1
A A A A A A A A A A A A A A A A E E E E E E E E E E E E E S S S 2 2 3 1 1 2 3 3 2 1 3 3 3 1 1 Q Q Q 2 3 1 3 2 1 1 1 1 1
A A A A A A A A A A A A A A A A E E E E E E E E E E E E E E S S 2 2 2 1 1 1 1 2 3 2 1 3 3 2 1 3 Q Q 2 3 1 Q 2 1 1 1 1 1
A A A Q A A A A A A A A A A A A E E E E E E E E E E E E E E E S 1 1 1 2 2 2 1 1 3 Q 2 2 3 2 1 3 Q Q 3 3 1 Q 2 1 1 1 1 1
A A A A A A A A A A A A A A A A E E E E E E E E E E E E E E E E 1 1 3 3 2 2 2 1 1 3 3 1 2 2 1 2 Q Q 3 3 1 Q 3 1 1 1 1 1
A A A A A A A A A A A A A A A A E E E E E E E E E E E E E E E 1 1 3 2 3 3 2 2 1 1 2 3 2 2 3 1 1 Q Q 3 3 1 Q Q 1 1 1 1 1
A A A A A A A A A A A A A A A A E E E E E E E E E E E E E E 1 2 3 2 3 3 3 3 2 2 1 1 2 3 2 2 3 1 2 Q 3 3 1 3 Q 1 1 1 1 1
A A A A A A A A A A A A A A A A E E E E E E E E E E E E 1 1 2 3 3 3 3 3 3 3 3 2 1 1 1 2 2 2 3 3 1 3 3 Q 1 3 Q 3 1 1 1 1
A A A A A A A A A A A A A A A A E E E E E E E E E E E 1 1 2 3 3 3 3 2 2 2 2 3 3 2 1 1 1 2 2 2 Q 2 1 2 2 1 Q Q Q 1 1 1 1
A A A A A A A A A A A A A A A A E E E E E E E E E E 1 1 3 2 2 3 3 2 2 2 2 2 2 2 2 1 1 1 2 3 2 3 3 2 1 1 1 Q Q Q 3 1 1 1
A A A A A A A A A A A A A A A A E E E E E E E E E 1 1 2 2 2 3 3 3 2 2 2 2 2 2 2 2 2 2 1 1 3 2 2 3 2 2 1 1 3 Q Q Q 2 1 1
A A A A A A A A A A A A A A A A E E E E E E E 1 1 1 3 2 2 1 1 2 3 3 2 2 2 2 2 2 2 2 2 2 1 2 2 2 3 3 2 1 1 1 Q Q Q Q 3 1
A A A A A A A A A A A A A A A A E E E E E E 1 1 1 3 3 3 2 2 2 1 1 2 3 3 2 2 2 2 2 2 1 3 2 1 2 2 3 3 2 2 1 1 1 Q Q Q Q 3
A A A A A A A A A A A A A A A A E E E E E 1 3 2 3 2 3 1 1 2 3 2 1 1 1 2 2 1 1 2 2 2 2 3 3 1 2 2 2 3 3 2 2 1 1 2 Q Q Q Q
A A A A A A A A A A A Q A A A A E E E E 1 1 3 2 3 2 2 1 2 2 1 3 3 2 1 1 1 2 2 2 2 2 1 2 2 1 1 2 2 3 3 2 1 2 1 1 2 Q Q Q
A A A A A A A A A A A A A A A A E E E E 1 2 2 3 2 1 1 1 2 3 2 1 3 2 2 2 2 2 2 2 2 2 2 3 3 2 1 1 2 3 3 3 2 2 2 1 1 1 Q Q
A A A Q A A A A A A A A A A A A E E E 1 1 2 2 3 1 1 1 1 1 1 2 2 1 1 1 2 1 1 2 2 2 3 3 2 1 2 1 1 2 2 2 2 2 1 2 2 1 1 1 3
A A Q A Q A A A A A A A A A A A E E E 1 2 2 3 1 1 1 1 1 1 1 1 2 3 1 1 2 1 2 2 1 2 2 2 3 3 2 1 1 2 2 1 1 1 2 2 2 1 1 1 1
A A A Q A A A A A A A A A A A A E E E 2 2 3 1 1 1 1 1 1 1 1 1 1 2 3 2 1 2 2 2 3 2 2 2 2 2 2 1 1 1 1 1 1 1 2 2 2 1 2 2 1
A A A A A A A A A A A A A A A A A E E 2 2 2 1 1 1 1 1 1 1 1 1 1 1 2 2 3 2 2 3 2 2 2 1 1 1 1 2 2 2 1 1 1 2 2 2 2 2 2 3 2
A A A A A A A A A A A A A A A A A A A 2 2 1 1 1 1 1 1 1 1 1 1 1 1 1 2 2 3 3 3 1 1 1 1 1 1 2 2 3 3 3 2 1 1 2 2 2 2 3 2 2
A A A A A A A A A A A A A A A A A A 2 2 1 1 1 1 2 1 1 1 1 1 1 1 1 1 3 2 3 2 1 1 1 1 1 2 3 3 3 3 3 3 3 2 3 1 2 2 2 3 2 2
A A A A A A A A A A A A A A A A A A 2 1 1 1 2 3 2 2 2 1 1 1 1 1 1 1 2 2 2 1 1 1 1 2 3 3 3 3 3 3 3 3 3 2 2 1 2 2 1 3 3 3
A A A A A A A A A A A A A A A A A A 1 1 1 2 3 2 2 1 2 2 1 1 1 1 1 E 1 1 1 2 1 1 2 3 3 3 3 3 3 3 3 3 3 3 3 2 1 2 2 3 3 3
A A A A A A A A A A A A A A A A A A 1 3 Q Q Q Q Q Q 3 2 1 1 1 1 E E 1 1 2 2 2 2 3 3 3 3 3 3 3 3 3 3 3 3 3 3 1 2 2 3 2 2
A A Q A A A A A A A A A A A A A A A Q Q 3 3 Q Q Q Q 3 1 1 1 1 E E 1 2 2 2 2 3 3 3 3 3 3 3 3 3 3 3 3 3 3 3 3 2 1 2 3 2 2
A A A A A A A A A A A A A A A A A 3 Q 2 2 Q Q Q Q Q 2 1 2 1 E E 1 1 3 2 2 2 3 3 3 3 3 3 3 3 3 3 3 3 3 3 2 3 2 2 1 3 2 2
A A A A A A A A A A A A A A A A A 3 3 Q Q Q Q Q Q 2 1 1 2 1 E E 1 2 2 2 2 3 3 3 3 3 3 3 3 3 3 3 3 3 2 3 3 3 3 3 1 3 2 3
A A A A A A A A A A A A A A A 2 3 Q Q Q Q Q Q 3 2 1 1 1 2 1 E 1 2 2 2 2 2 3 3 3 3 3 3 3 3 3 3 3 3 3 2 3 3 3 2 3 2 1 2 3
A A A A A A A A A A A A A A 3 Q Q Q 3 3 3 3 2 1 2 2 1 2 1 1 1 1 2 2 2 2 2 2 3 3 3 3 3 3 2 3 3 3 2 2 2 2 3 2 3 Q Q 1 1 2
A A A A A A A A A A A A 2 Q Q Q 3 3 3 3 Q Q Q 3 1 2 3 2 1 2 2 1 2 2 2 2 2 2 2 2 3 3 2 2 3 3 3 2 3 2 3 2 1 Q Q Q Q 3 1 2
A A A A A A A A A A A A Q Q 3 2 2 2 2 2 2 1 2 Q Q 2 2 3 1 1 1 2 3 2 2 2 2 2 2 2 3 3 2 2 2 2 3 3 3 2 2 2 Q Q Q Q Q Q 1 1
A A A A A A A A A A A A Q 3 2 2 2 2 2 2 2 2 2 2 3 3 2 3 3 1 1 Q Q Q Q 3 3 3 3 2 2 2 1 2 3 2 2 2 2 3 Q Q 3 Q Q Q Q Q 2 2
A A A A A A A A A A A A 3 2 2 2 2 2 2 2 2 2 2 2 3 2 2 3 2 1 2 Q 2 Q Q Q Q Q Q Q Q 3 3 2 3 3 3 Q Q Q Q Q 3 Q Q Q Q 3 3 2
A A A A A A A Q A A A A 2 2 2 2 3 3 3 3 3 3 2 2 2 3 2 2 2 1 2 Q 3 2 Q Q Q Q Q Q Q Q Q Q Q Q Q Q Q Q Q Q Q Q Q Q 1 Q 3 2
A A A A A A A A A A A A 2 2 3 2 2 2 2 3 3 2 2 3 2 2 2 2 1 1 2 Q Q 2 2 3 3 3 3 3 Q Q Q Q Q Q Q Q Q Q Q Q Q Q Q 2 1 Q Q Q
A A A A A A A A A A A A 3 2 3 3 3 3 3 3 2 2 2 2 2 2 2 2 2 1 1 Q Q 3 2 2 2 3 2 2 3 Q Q Q Q Q Q Q Q Q Q Q Q Q 3 1 3 Q Q Q
A A A A A A A A A A A A 2 2 1 1 1 1 1 1 1 1 2 2 2 2 3 1 2 1 1 Q Q 3 2 1 1 3 2 2 3 Q Q 2 Q Q Q Q Q Q Q Q 3 1 1 1 Q Q Q Q
A A A A A A A A A A A A 2 1 1 1 1 1 1 2 1 1 1 1 2 2 2 2 1 2 1 2 Q 3 2 1 1 2 3 2 3 Q 3 3 Q Q Q Q Q Q Q 3 1 1 1 Q Q Q Q Q
A A A A A A A A A A A A 2 1 1 2 3 Q Q Q Q 2 1 1 1 1 2 2 2 1 1 1 Q Q 2 1 1 1 1 1 3 Q 3 Q Q Q Q Q Q 2 2 1 1 2 3 Q Q Q Q Q
A A A A A A A A A A A 3 1 1 3 Q Q Q Q Q Q Q 1 2 1 1 2 2 1 2 2 1 2 Q Q 2 1 1 1 1 2 3 3 Q Q 3 3 2 2 1 1 2 3 Q Q Q 3 2 3 Q
A A A A A A A A A 2 Q 3 1 Q Q Q Q Q Q Q Q 3 2 1 2 1 2 2 1 2 1 1 1 Q Q 2 2 1 1 1 1 3 3 Q Q Q Q Q Q Q Q Q Q Q 3 2 2 3 Q Q
A A A A A A A A Q Q Q 2 Q Q Q Q Q Q Q Q Q 2 3 3 1 2 2 1 2 2 1 E 1 3 Q 2 1 1 1 1 1 2 3 Q Q Q Q Q Q Q Q Q 3 2 1 3 Q Q Q Q
A A A A A A 2 Q Q Q 2 3 Q Q Q Q Q Q Q Q 3 1 Q Q 3 2 1 A A A 1 E 1 1 Q 3 2 2 1 1 1 2 3 Q 3 2 Q Q Q Q 3 2 2 2 Q Q Q Q 3 2
A A A A A A Q Q 3 Q 3 2 2 3 Q Q Q Q Q Q 2 2 Q Q Q 3 A A A E E E E 1 Q Q 3 2 2 1 1 1 3 2 2 Q Q Q Q 2 2 2 3 3 3 3 2 1 1 2
A A A A A 2 Q 3 3 3 Q 3 2 1 1 1 1 2 3 2 2 3 Q Q Q Q 2 A A E E E E 1 3 Q Q Q 3 3 2 1 1 2 3 Q Q Q 2 2 3 Q 3 2 2 1 1 3 Q Q
A A A A A 2 Q 2 Q Q Q Q Q Q 3 3 2 1 1 1 2 3 Q Q Q Q Q 2 A A E E E 1 2 Q Q Q Q 3 3 1 1 3 3 Q 3 1 2 3 3 2 1 1 1 3 Q Q Q Q
A A A A A A Q 2 3 Q Q Q Q Q Q Q Q Q Q Q Q Q 3 Q Q Q Q Q A A E E E 2 2 Q Q Q Q 3 2 1 1 3 3 2 2 1 1 2 1 1 2 1 2 Q Q Q Q Q
A A A A A A 2 3 Q 3 2 2 Q Q Q Q Q Q Q Q Q 2 2 3 Q Q 2 Q Q A A E E A 1 Q Q Q 3 2 3 1 1 3 2 2 1 1 1 1 1 2 2 1 Q Q Q 3 2 2
A A A A A A A 3 Q 3 2 2 2 2 3 3 2 3 2 3 2 2 2 A 2 A A Q Q 2 A A E E 1 Q Q 3 2 3 3 2 1 2 2 1 1 1 1 2 2 2 1 3 Q 3 3 1 1 3
A A A A A A A 3 Q 3 2 Q 3 Q 2 2 2 2 2 2 A A A A A A A 2 Q 3 A A A A A Q Q Q Q Q 3 2 1 2 2 1 1 1 2 2 2 2 1 1 2 2 3 3 1 3
A A A A A A A Q Q 2 2 Q Q Q A 2 Q Q Q 2 A A A A 2 2 Q Q Q A A A A A A Q Q Q Q Q Q 2 1 2 1 1 1 1 3 2 2 1 1 1 2 3 3 Q 3 1
A A A A A A A 3 3 A 3 Q Q 2 A 3 Q Q Q 2 A A A A 2 Q Q 2 A A A A A A A Q Q Q Q Q Q 2 1 1 1 1 2 3 3 2 1 1 1 3 3 1 2 Q Q 2
A A A A A A A A A A Q Q Q A A 3 Q Q Q 2 A A A A 2 2 A A A A A A A A A 3 Q Q Q Q Q 3 2 1 2 1 1 1 2 2 1 1 1 3 3 3 1 2 Q Q
A A A A A A A A A A Q Q 2 A A 2 Q Q Q A A A A A A A A A A A A A A A A 3 Q Q Q Q 3 3 3 3 3 1 1 1 1 3 2 1 2 2 3 Q 2 1 3 Q
A A A A A A A A A A Q Q 3 3 A 2 Q Q 2 A A A A A A A A A A A A A A A A 2 Q Q Q Q Q Q Q 3 3 2 1 1 1 1 2 1 3 2 1 3 Q 2 1 3
A A A A A A A A A A Q Q 3 2 A 2 Q Q 2 2 A A A A A A A A A A A Q A A A 2 Q Q Q Q Q Q Q 3 3 3 3 3 2 1 1 1 2 3 2 1 3 Q 2 1
A A A A A A A A A A 3 3 2 3 A 2 3 2 3 2 A A A A A A A A A A Q A Q A A A Q 3 3 3 3 3 3 3 3 3 3 3 2 2 1 1 1 2 3 2 1 3 3 2
A A A A A A A A A A A 3 Q Q A 2 3 Q 3 A A A A A A A A A A A A Q A A A A Q 3 3 2 1 2 2 3 3 3 2 2 2 2 1 1 1 1 2 3 2 1 3 3
A A A A A A A A A A A Q Q 2 A A Q Q Q A A A A A A A A A A A A A A A A A 3 Q Q Q Q Q Q 3 2 2 2 2 3 2 2 2 1 1 1 2 3 2 2 2
A A A A A A A A A A A Q Q 2 A A 2 Q Q 2 A A A A A A A A A A A A A A A A A Q Q Q Q Q Q Q Q Q 3 Q 3 2 Q 2 1 1 1 1 2 3 3 1
A A A A A A A A A A A 2 2 2 2 A A Q Q 2 A A A A A A A A A A A A A A A A A 2 Q Q Q Q Q Q Q Q 3 2 1 3 2 1 1 1 1 1 1 2 2 1
A A A A A A A A A A A A A A A A A 3 Q 2 A A A A A A A A A A A A A A A A A A 2 Q Q Q Q Q 3 2 1 2 3 2 1 1 1 2 3 1 1 2 2 1
A A A A A A A A A A A A A A A A A 3 3 A A A A A A A A A A A A A A A A A A A A Q Q 2 2 2 2 2 2 2 2 2 3 3 2 3 3 1 1 1 2 1
A A A A A A A A A A A A A A A A A A A A A A A A A A A A A A A A A A A A A A A 2 Q Q Q Q 3 1 1 1 1 1 3 3 3 3 1 1 1 1 1 2
A A A A A A A A A A A A A A A A A A A A A A A A A A A A A A A A A A A A A A A A 3 Q Q 1 1 1 E E E 1 1 2 3 3 1 1 3 2 2 3
A A A A A A A A A A Q A A A A A A A A A A A A A A A A A A A A A A A A A A A A A A 3 1 1 E E E E E E 1 1 1 3 3 2 3 1 2 3
A A A A A A A A A Q A Q A A A A A A A Q A A A A A A A A A A A A A A A A A A A A A 1 E E E E E E E E E E E 1 2 2 2 1 1 2
A A A A A A A A A A Q A A A A A A A A A A A A A A A A A A A A A A A A A A A A A 1 E E 1 1 1 1 1 1 1 E E E E 1 1 3 3 1 2
A A A A A A A A A A A A A A A A A A A A A A A A A A A A A A A A A A A A A A A A E E 1 1 1 1 1 1 1 1 1 1 E E E E 1 2 2 1
A A A A A A A A A A A A A A A A A A A A A A A A A A A A A A A A A A A A A A A E E 1 1 1 1 1 1 1 1 1 1 1 1 E E E E 1 1 1
A A A A A A A A A A A A A A A A A A A A A A A A A A A A A A A A A A A A A A E E 1 1 1 1 1 1 1 1 1 1 1 1 1 1 1 E E E E 1
A A A A A A A A A A A A A A A A A A A A A A A A A A A A A A A A A A A A A E E 1 1 1 1 1 1 1 1 1 1 1 1 1 1 1 1 1 1 E E E
A A A A A A A A A A A A A A A A A A A A A A A A A A A A A A A A A A A A E E 1 1 1 1 1 1 1 1 1 1 1 1 1 1 1 1 1 1 1 1 1 E
A A A A A Q A A A A A A A A A A A A A A A A A A A A A A Q A A A A A A E E 1 1 1 1 1 1 1 1 1 1 1 1 1 1 1 1 1 1 1 1 1 1 1
A A A A A A A A A A A A A A A A A A A A A A A A A A A A A A A A A A A E 1 1 1 1 1 1 1 1 1 1 1 1 1 1 1 1 1 1 1 1 1 1 1 1
A A A A A A A A A A A A A A A A A A A A A A A A A A A A A A A A A A E E 1 1 1 1 1 1 1 E E E E E E E E E 1 1 1 1 1 1 1 1
A A A A A A A A A A A A A A A A A A A A A A A A A A A A A A A A A E E 1 1 1 1 1 E E E E E E E E E E E E E E E 1 1 1 1 1
A A A A A A A A A A A A A A A A A A A A A A A A A A A A A A A A A E E 1 1 1 1 E E E E E E E E E E E E E E E E E 1 1 1 1
A A A A A A A A A A A A A A A A A A A A A A A A A A A A A A A A E E 1 1 1 1 E E E E E E E E E E E E E E E E E E E 1 1 1
A A A A A A A A A A A A A A A A A A A A A A A A A A A A A A A E E 1 1 1 E E E E E E E E E E E E E E E E E E E E E E 1 1
A A A A A A A A A A A A A A A A A A A A A A A A A A A A A A A E E 1 1 E E E E E E E E E E E E E E E E E E E E E E E 1 1
A A A A A A A A A A A A A A A A A A A A A A A A A A A A A A E E E 1 E E E E E E E E E E E E E E E E E E E E E E E E E 1
A A A A A A A A A A A A A A A A A A A A A A A A A A A A A A E E E E E E E E E E E E E E E E E E E E E E E E E E E E E E
A A A A A Q A A A A A A A A A A A A A A A A A A A A A A A A E E E E E E E E E E E E E E E E E E E E E E E E E E E E E E
A A A A A A A A A A A A A A A A A A A A A A A A A A A A A A E E E E E E E E E E E E E E E E E E E E E E E E E E W W 1 E
A A A A A A A A A A A A A A A A A A A A A A A A A A A A A A E E E E E E E E E E E E E E E E E E E E E E E E E 1 1 W W 1
A A A A A A A A A A A A A A A A A A A A A A A A A A A A A A A E E E E E E E E E E E E E E E E E E E E E E E W 1 E E 2 W
A A A A A A A A A A A A A A A A A A A A A A A A A A A A A A A A E E E E E E E E E E E E E E E E E E E E E E 1 W E 1 2 2
A A A A A A A A A A A A A A A A A A A A A A A A A A A A A A A A E E E E E E E E E E E E E E E E E E E E E E 1 W 2 3 3 3
A A A A A A A A A A A A A A A A A A A A A A A A A A A A A A A A A E E E E E E E E E E E E E E E E E E E E E W 2 3 3 3 3
A A A A A A A A A A A A Q A A A A A A A A A A A A A A A A A A A A A E E E E E E E E E E E E E E E E E E E E E E 2 3 3 3
A A A A A A A A A A A A A A A A A A A A A A A A A A A A A A A A A A A E E E E E E E E E E E E E E E E E E E E E E 2 3 3
A A A A A A A A A A A A A A A A A A A A A A A A A A A A A A A A A A A A E E E E E E E E E E E E E E E E E E E E E 2 3 3
A A A A A A A A A A A A A A A A A A A A A A A A A A A A A A A A A A A A A E E E E E E E E E E E E E E E W W W W E 2 3 3
A A A A A A A A A A A A A A A A A A A A A A A A A A A A A A A A A A A A A A E E E E E E E E E E E E E 1 W W W W W 1 2 2
A A A A A A A A A A A A A A A A A A A A A A A A A A A A A A A A A A A A A A A A E E E E E E E E E E 1 W W W 1 1 W W 2 3
A A A A A A A A A A A A A A A A A A A A A A A A A A A A A A A A A A A A A A A A A E E E E E E E E W W W W 1 1 1 1 1 3 Q
A A A A A A A A A A A A A A A A A A Q A A A A A A A A A A A A A A A A A A A A A A A E E E E E E E W W W W 1 1 1 1 2 Q 3
A A A A A A A Q A A A A A A A A A Q A Q A A A A A A A A A A A A A A A A A A A A A A A A E E E E 1 W W W W 1 1 1 2 Q Q 2
A A A A A A A A A A A A A A A A A A Q A A A A A A A A A A A A A A A A A A A A A A A A A A E E W W W W W W W W 1 2 3 2 1
A A A A A A A A A A A A A A A A A A A A A A A A A A A A A A A A A A A A A A A A A A A A A A A W W W W W W 1 W W 1 1 1 W
A A A A A A A A A A A A A A A A A A A A A A A A A A A A A A A A A A A A A A A A A A A A A A W W W W W W W W 1 W W 1 1 2
A A A A A A A A A A A A A A A A A A A A A A A A A A A A A A A A A A A A A A A A A A A A A A W W W W W W W W 1 1 W W W 1
A A A A A A A A A A A A A A A A A A A A A A A A A A A A A A A A A A A A A A A A A A A A A W W W W W W W W W 1 1 1 1 W W
A A A A A A A A A A A A A A A A A A A A A A A A A A A A A A A A A A A A A A A A A A A A W W W W W W W W W 1 1 1 1 1 1 1
A A A A A A A A A A A A A A A A A A A A A A A A A A A A A A A A A A A A A A A A A A A A W W W W W W W W W 1 1 1 1 1 1 1
A A A A A A A A A A A A A A A A A A A A A A A A A A A A A A A A A A A A A A A A A A A A W W W W W W W W 1 1 1 1 1 1 1 1
A A A A A A A A A A A A A A A A A A A A A A A A A A A A A A A A A A A A A A A A A A A A A W W W W W W 1 1 1 1 1 1 1 W W
A A A A A A A A A A A A A A A A A A A A A A A A A A A A A A A A A A A A A A A A A A A A A W W W W W W 1 1 1 1 1 1 1 W W
A A A A A A A A A A A A A A A A A A A A A A A A A A A A A A A A A A A A A A A A A A A A A A W W W W 1 1 1 1 1 1 1 W W W
A A A A A A A A A A A A A A A A A A A A A A A A A A A A A A A A A A A A A A A A A A A A A A W W W W 1 1 1 1 1 1 W W W A
A A A A A A A A A A A A A A A A A A A A A A A A A A A A A A A A A A A A A A A A A A A A A A A W 1 1 1 1 1 1 1 W W W A A
A A A A A A A A A A A A A A A A A A A A A A A A A A A A A A A A A A A A A A A A A A A A A A A A W 1 1 1 1 1 1 1 W A A A
A A A A A A A A A A A A A A A A A A A A A A A A A A A A A A A A A A A A A A A A A A A A A A A A A W W W W W W W A A A A
A A A A A A A A A A A A A A A A A A A A A A A A A A A A A A A A A A Q A A A A A A A A A A A A A A A A A A A A A A A A A
A A Q A A A A A A A A A A A A A A A A A A A A A A A A A A A A A A A A A A A A A A A A A A A A A A A A A A A A A A A A A
A A A A A A A A A A A A A A A A A A A A A A A A A A A A A A A A A A A A A A A A A A A A A A A A A A A A A A A A A A A A
A A A A A A A A A A A A A A A A A A A A A A A A A A A A A A A A A A A A A A A A A A A A A A A A A A A A A A A A A A A A
A A A A A A A A A A A A A A A A A A A A A A A A A A A A A A A A A A A A A A A A A A A A A A A A A A A A A A A A A A A A
A A A A A A A A A A A A A A A A A A A A A A A A A A A A A A A A A A A A A A A A A A A A A A A A A A A A A A A A A A A A
A A A A A A A A A A A A A A A A Q A A A A A A A A A A A A A A A A A A A A A A A A A A A A A A A A A A A A A A A A A A A
A A A A A A A A A A A A A A A A A A A A A A A A A A A A A A A A A A A A A A A A A A A A A A A A A A A A A A A A A A A A
A A A A A A A A A A A A A A A A A A A A A A A A A A A A A A A A A A A A A A A A A A A A A A A A A A A A A A A A A A A A
A A A A A A A A A A A A A A A A A A A A A A A A A A A A A A A A A A A A A A A A A A A A A A A A A A A A A A A A A A A A
A A A A A A A A A A A A A A A A A A A A A A A A A A A A A A A A A A A A A A A A A A A A A A A A A A A A A A A A A A A A
A A A A A A A A A A A A A A A A A A A A A A A A A A A A A A A A A A A A A A A A A A A A A A A A A A A A A A A A A A A A
A A A A A A A A A A A A A A A A A A A A A A A A A A A A A A A A A A A A A A A A A A A A A A A A Q A A A A A A A A A A A
A A A A A A A A A A A A A A A A A A A A A A A A A A A A A A A A A A A A A A A A A A A A A A A A A A A A A A A A A A A A
A A A A A A A A A A A A A A A A A A A A A A A A A A A A A A A A A A A A A A A A A A A A A A A A A A A A A A A A A A A A
A A A A A A A A A A A A A A A A A A A A A A A A A A A A A A A A A A A A A A A A A A A A A A A A A A A A A A A A A A A A
A A A A A A A A A A A A A A A A A A A A A A A A A A A A A A A A A A A A A A A A A A A A A A A A A A A A A A A A A A A A
A A A A A A A A A A A A A A A A A A A A A A A A A A A A A A A A A A A A A A A A A A A A A A A A A A A A A A A A A A A A
A A A A A A A A A A A A A A A A A A A A A A A A A A A A A A A A A A A A A A A A A A A A A A A A A A A A A A A A A A A A
