A A A A A A A A A A A A A A A A A A A A
A A A A A A A A A A A A A A A A A A A A
A A A A A A A A A A A A A A A A A A A A
A A A A A A A A A A A A A A A A A A A A
A A A A A A A A A A A A A A A A A A A A
A A A A A A A A A A A A A A A A A A A A
A A A A A A A A A A A A A A A A A A A A
A A A A A A A A A A A A A A A A A A A A
A A A A A A A A A A A A A A A A A A A A
A A A A A A A A A A A A A A A A A A A A
A A A A A A A A A A A A A A A A A A A A
A A A A A A A A A A A A A A A A A A A A
A A A A A Q A A A A A A A A A A A A A A
A A A A A A A A A A A A A A A A A A A A
A A A A A A A A A A A A A A A A A A A A
A A A A A A A A A A A A A A A A A A A A
A A A A A A A A A A A A A A A A A A A A
A A A A A A A A A A A A A A A A A A A A
A A A A A A A A A A A A A A A A A A A A
A A A A A A A A A A A A A A A A A A A A
A A A A A A A A A A A A A A A A A A A A
A A A A A A A A A A A A Q A A A A A A A
A A A A A A A A A A A A A A A A A A A A
A A A A A A A A A A A A A A A A A A A A
A A A A A A A A A A A A A A A A A A A A
A A A A A A A A A A A A A A A A A A A A
A A A A A A A A A A A A A A A A A A A A
A A A A A A A A A A A A A A A A A A A A
A A A A A A A A A A A A A A A A A A A A
A A A A A A A A A A A A A A A A A A A A
A A A A A A A A A A A A A A A A A A A A
A A A A A A A A A A A A A A A A A A A A
A A A A A A A A A A A A A A A A A A A A
A A A A A A A A A A A A A A A A A A A A
A A A A A A A A A A A A A A A A A A A A
A A A A A A A A A A A A A A A A A A A A
A A A A A A A A Q A A A A A A A A A A A
A A A A A A A Q A Q A A A A A A A A A A
A A A A A A A A Q A A A A A A A A A A A
A A A A A A A A A A A A A A A A A A A A
A A A A A A A A A A A A A A A A A A A A
A A A A A A A A A A A A A A A A A A A A
A A A A A A A A A A A A A A A A A A A A
A A A A A A A A A A A A A A A A A A A A
A A A A A A A A A A A A A A A A A A A A
A A A A A A A A A A A A A A A A A A A A
A A A A A A A A A A A A A A A A A A A A
A A A A A A A A A A A A A A A A A A A A
A A A A A A A A A A A A A A Q A A A A A
A A A A A A A A A A A A A A A A A A A A
A A A A A A A A A A A A A A A A A A A A
A A A A A A A A A A A A A A A A A A A E
A A A A A A A A A A A A A A A A A A A E
A A A A A A A A A A A A A A A A A A A E
A A A A A A A A A A A A A A A A A A E E
A A A A Q A A A A A A A A A A A A A E E
A A A Q A Q A A A A A A A A A A A A E E
A A A A Q A A A A A A A A A A A A E E E
A A A A A A A A A A A A A A A A A E E E
A A A A A A A A A A A A A A A A A E E E
A A A A A A A A A A A A A A A A A E E E
A A A A A A A A A A A A A A A A E E E E
A A A A A A A A A A A A A A A A E E E E
A A A A A A A A A A A A A A A A E E E E
A A A A A A A A A A A A A A A A E E E E
A A A A A A A A A A A A A A A A E E E E
A A A A A A A A A A A A A A A A E E E E
A A A A A A A A A A A A A A A A E E E E
A A A A A A A A A A A A A A A A E E E E
A A A Q A A A A A A A A A A A A E E E E
A A A A A A A A A A A A A A A A E E E E
A A A A A A A A A A A A A A A A E E E E
A A A A A A A A A A A A A A A A E E E E
A A A A A A A A A A A A A A A A E E E E
A A A A A A A A A A A A A A A A E E E E
A A A A A A A A A A A A A A A A E E E E
A A A A A A A A A A A A A A A A E E E E
A A A A A A A A A A A A A A A A E E E E
A A A A A A A A A A A A A A A A E E E E
A A A A A A A A A A A A A A A A E E E E
A A A A A A A A A A A Q A A A A E E E E
A A A A A A A A A A A A A A A A E E E E
A A A Q A A A A A A A A A A A A E E E A
A A Q A Q A A A A A A A A A A A E E E A
A A A Q A A A A A A A A A A A A E E E 2
A A A A A A A A A A A A A A A A A E E 2
A A A A A A A A A A A A A A A A A A A 2
A A A A A A A A A A A A A A A A A A 2 2
A A A A A A A A A A A A A A A A A A 2 A
A A A A A A A A A A A A A A A A A A A A
A A A A A A A A A A A A A A A A A A A 3
A A Q A A A A A A A A A A A A A A A Q Q
A A A A A A A A A A A A A A A A A 3 Q 2
A A A A A A A A A A A A A A A A A 3 3 Q
A A A A A A A A A A A A A A A 2 3 Q Q Q
A A A A A A A A A A A A A A 3 Q Q Q 3 3
A A A A A A A A A A A A 2 Q Q Q 3 3 3 3
A A A A A A A A A A A A Q Q 3 2 2 2 2 2
A A A A A A A A A A A A Q 3 2 2 2 2 2 2
A A A A A A A A A A A A 3 2 2 2 2 2 2 2
A A A A A A A Q A A A A 2 2 2 2 3 3 3 3
A A A A A A A A A A A A 2 2 3 2 2 2 2 3
A A A A A A A A A A A A 3 2 3 3 3 3 3 3
A A A A A A A A A A A A 2 2 1 1 1 1 1 1
A A A A A A A A A A A A 2 1 1 1 1 1 1 2
A A A A A A A A A A A A 2 1 1 2 3 Q Q Q
A A A A A A A A A A A 3 1 1 3 Q Q Q Q Q
A A A A A A A A A 2 Q 3 1 Q Q Q Q Q Q Q
A A A A A A A A Q Q Q 2 Q Q Q Q Q Q Q Q
A A A A A A 2 Q Q Q 2 3 Q Q Q Q Q Q Q Q
A A A A A A Q Q 3 Q 3 2 2 3 Q Q Q Q Q Q
A A A A A 2 Q 3 3 3 Q 3 2 1 1 1 1 2 3 2
A A A A A 2 Q 2 Q Q Q Q Q Q 3 3 2 1 1 1
A A A A A A Q 2 3 Q Q Q Q Q Q Q Q Q Q Q
A A A A A A 2 3 Q 3 2 2 Q Q Q Q Q Q Q Q
A A A A A A A 3 Q 3 2 2 2 2 3 3 2 3 2 3
A A A A A A A 3 Q 3 2 Q 3 Q 2 2 2 2 2 2
A A A A A A A Q Q 2 2 Q Q Q A 2 Q Q Q 2
A A A A A A A 3 3 A 3 Q Q 2 A 3 Q Q Q 2
A A A A A A A A A A Q Q Q A A 3 Q Q Q 2
A A A A A A A A A A Q Q 2 A A 2 Q Q Q A
A A A A A A A A A A Q Q 3 3 A 2 Q Q 2 A
A A A A A A A A A A Q Q 3 2 A 2 Q Q 2 2
A A A A A A A A A A 3 3 2 3 A 2 3 2 3 2
A A A A A A A A A A A 3 Q Q A 2 3 Q 3 A
A A A A A A A A A A A Q Q 2 A A Q Q Q A
A A A A A A A A A A A Q Q 2 A A 2 Q Q 2
A A A A A A A A A A A 2 2 2 2 A A Q Q 2
A A A A A A A A A A A A A A A A A 3 Q 2
A A A A A A A A A A A A A A A A A 3 3 A
A A A A A A A A A A A A A A A A A A A A
A A A A A A A A A A A A A A A A A A A A
A A A A A A A A A A Q A A A A A A A A A
A A A A A A A A A Q A Q A A A A A A A Q
A A A A A A A A A A Q A A A A A A A A A
A A A A A A A A A A A A A A A A A A A A
A A A A A A A A A A A A A A A A A A A A
A A A A A A A A A A A A A A A A A A A A
A A A A A A A A A A A A A A A A A A A A
A A A A A A A A A A A A A A A A A A A A
A A A A A Q A A A A A A A A A A A A A A
A A A A A A A A A A A A A A A A A A A A
A A A A A A A A A A A A A A A A A A A A
A A A A A A A A A A A A A A A A A A A A
A A A A A A A A A A A A A A A A A A A A
A A A A A A A A A A A A A A A A A A A A
A A A A A A A A A A A A A A A A A A A A
A A A A A A A A A A A A A A A A A A A A
A A A A A A A A A A A A A A A A A A A A
A A A A A A A A A A A A A A A A A A A A
A A A A A Q A A A A A A A A A A A A A A
A A A A A A A A A A A A A A A A A A A A
A A A A A A A A A A A A A A A A A A A A
A A A A A A A A A A A A A A A A A A A A
A A A A A A A A A A A A A A A A A A A A
A A A A A A A A A A A A A A A A A A A A
A A A A A A A A A A A A A A A A A A A A
A A A A A A A A A A A A Q A A A A A A A
A A A A A A A A A A A A A A A A A A A A
A A A A A A A A A A A A A A A A A A A A
A A A A A A A A A A A A A A A A A A A A
A A A A A A A A A A A A A A A A A A A A
A A A A A A A A A A A A A A A A A A A A
A A A A A A A A A A A A A A A A A A A A
A A A A A A A A A A A A A A A A A A Q A
A A A A A A A Q A A A A A A A A A Q A Q
A A A A A A A A A A A A A A A A A A Q A
A A A A A A A A A A A A A A A A A A A A
A A A A A A A A A A A A A A A A A A A A
A A A A A A A A A A A A A A A A A A A A
A A A A A A A A A A A A A A A A A A A A
A A A A A A A A A A A A A A A A A A A A
A A A A A A A A A A A A A A A A A A A A
A A A A A A A A A A A A A A A A A A A A
A A A A A A A A A A A A A A A A A A A A
A A A A A A A A A A A A A A A A A A A A
A A A A A A A A A A A A A A A A A A A A
A A A A A A A A A A A A A A A A A A A A
A A A A A A A A A A A A A A A A A A A A
A A A A A A A A A A A A A A A A A A A A
A A A A A A A A A A A A A A A A A A A A
A A A A A A A A A A A A A A A A A A A A
A A Q A A A A A A A A A A A A A A A A A
A A A A A A A A A A A A A A A A A A A A
A A A A A A A A A A A A A A A A A A A A
A A A A A A A A A A A A A A A A A A A A
A A A A A A A A A A A A A A A A A A A A
A A A A A A A A A A A A A A A A Q A A A
A A A A A A A A A A A A A A A A A A A A
A A A A A A A A A A A A A A A A A A A A
A A A A A A A A A A A A A A A A A A A A
A A A A A A A A A A A A A A A A A A A A
A A A A A A A A A A A A A A A A A A A A
A A A A A A A A A A A A A A A A A A A A
A A A A A A A A A A A A A A A A A A A A
A A A A A A A A A A A A A A A A A A A A
A A A A A A A A A A A A A A A A A A A A
A A A A A A A A A A A A A A A A A A A A
A A A A A A A A A A A A A A A A A A A A